3333333333343333333333343434343333343433343434343333000000000000000000000000000000000000000000343433
3300000000000000000000000000000000000000000000000000000000000000000000000000000000000000000000000033
3400000000000000000000000000000000000000000000000000000000000000000000000000000000000000000000000034
3334343333343434330000000034333433343400000000000000000000000000000000000000000000000000000000000033
3300000000000000340000000034000000000000000000000000000000000000000000000000000000000000000000000034
3400000000000000330000000034000000000000000000000000000000000000000000000000000000000000000000000034
3300000000000000340000000033000000000000000000000000000000f0f1f2f3f4f5f6f7f8f9fafbfcfdfeff0000000033
3400000000000000340000000034000000000000000000313131313131000000000000000000000038333131142121211112
3400000000000000330000000034000000000000000000000000000000000000000000000000000000000000202121212122
3300000000000000340000000033000000393839390000000000000000000000000000000000000000000000303131313114
3400000000000000340000000034000000000000000000000000000000000000000000000000000000000000000000000020
3400000000000000340000000033000000000000000000000000000000000000000000000038000000000000000000000020
3400000000000000330000000034000000000039393938380000000000000000000000000000000000000000000000000020
340000000000000000000000003400000000000000000000000000ff16160000380000000000000000000000000000000020
340000000000000000000000003400000000000000000000000000fe16160000000000000000000000101111111111111124
340000000000000000000000003300003838390000000000000000fd16160000000039000000000000202121212121212121
340000000000000000000000003400000000000000000000000000fc16160000001516161617000000202121212121212121
343434340000000000003433333400000000000000000000000000fb16160000002526262627000000202121212121212121
330000000000000000000000000000000000000038390000000000fa16160000002526262627000000202121212121212121
330000000000000000000000000000000000000000000000000000f916160000151616161616170000202121212121212121
340000001516161617000000000000000000000000000000000000f816160000252626262626270000202121212121212121
330000003536363637000000000000000000000000000000000000f716163334111111111111111111242121212121213132
330000000000000000000000000000000000000000000000000000f616161616000000000000000000000000000000000034
340000000000000000000015161700000000000000000000000000f516161616000000000000000000000000000000000033
330000000000000000000025262700000000000000000000000000f416161616000000000000000000000000000000000034
340000000000000000000025262700000000000000000000000000f316161616000000000000000000000000000000000033
330000000000000000001529262817000000000000000000000000f216161616000000000000000000000000000000000034
330000000000000000002526262627000000000000000000000000f116161616000000000000000000000000000000000033
340000000000000000003536363637000000101111120000000000f016161616000000000000000000000000000000000034
3334333433343333343434343333343433333031313234343433333434343433343433333334343334333433343434343333

image image:bg
sprite @46,13 sprite:hero 0x00000000
