1331313131313131313131313131142121212121
2200000000000000000000000000202121212121
2200000000000000000000000000303131313114
2200000000000000000000000000000000000020
2200000000000038000000000000000000000020
2200000000000000000000000000000000000020
2200380000000000000000000000000000000020
2200000000000000000000101111111111111124
2200000039000000000000202121212121212121
2200001516161617000000202121212121212121
2200002526262627000000202121212121212121
2200002526262627000000202121212121212121
2200151616161616170000202121212121212121
2200252626262626270000202121212121212121
2311111111111111111111242121212121212121

image image:bg
sprite @15,6 sprite:hero 0x00000000
