2121212121212121212121212121212121212121212121212200002021212121212121212121212121212121212121212121
3131313131313131313131313131313131313131313131142200002013313131313131313131313131313131313131313131
0000000000000000000000000000000000000000000000202200002022000000000000000000000000000000000000000000
0000000000000000000000000000000000000000000000202200002022000000000000000000000000000000000000000000
0405020507080205030000000000000000000000000000202200002022000000000000000000000000000000000000000404
1111111111111111120000000000000502060106080000202200002022000000000000000000000000000000000306011011
21133131313131313200000000000010111111111200002022000020220107040f0202020604060308010402021011112421
21220000000000000000000000000030313131313200002022000020231111121f1011111111111111111111112421212121
21220000000000000000000000000000000000000000002022000020212121221f2021212121212121212121212121212121
21220000000000000000000000000000000000000000002022000020133131321f3031313131313131313131313131313131
21220000000000020503060708040000000000000000003032000030320000001f0000000000000000000000004041424344
21220000000000101111111111120000000000000000000000000000000000001f0000000000000000000000005051525354
21220000000000303131313131320000000000000000000000000000000000001f0000000000000000000000006061626364
21220000000000000000000000000000000000000106020701050304070203051f0405040000000000080206027071727374
2122000000000000000000000000000000000000101111111111111111111111111111120102070103101111128081828384
2122000000000000000000000000000000000000303131313131313131313131313131321516161617202121212121212121
2122000000000000000000000000000000000000000000000000000000000000000000002526262627303131142121212121
2122010605020f02080107050800000000000000000000000000000000000000000000002526262627000000202121212121
2123111111121f10111111111200000000000000000000000000000000000000000000022526262627080000202121212121
2121212121221f20212121212200000000000000000000000000000000000000000000101111111111120000202121212121
2121212121221f20212121212201060000000000000001070200000000000000000000202121212121220000202121212121
2113313131321f30313131142215170000000000000015161700000000020803050703202121212121220000201331313131
2122000000001f00000000202235370000000000000025262700000000151616161617202121212121220000202200000000
2122000000001f00000000202200000000000000000025262700000000252626262627202121212121220000202200000000
3132000000001f00000000202200000000000000000525262702000000252626262627303131313131320000303200000000
0000000000001f00000000202200000000000000001516161617000000252626262627000000000000000000000000000201
0000000000001f00000000202200000000000000002526262627000000252626262627000000000000000000000000001011
0404070106021f03080801202203050f03070706042526262627020707252626262627010803070601080103080803052021
1111111111111111111111242311121f10111111111111111111111111111111111111111111111111111111111111112421
2121212121212121212121212121221f20212121212121212121212121212121212121212121212121212121212121212121

image image:bg
sprite @46,13 sprite:hero 0x00000000
door @0,3 map:nw @39,25 0x0000
door @25,0 map:n @25,39 0x0000
door @49,3 map:ne @0,25 0x0000
door @0,26 map:sw @39,12 0x0000
door @15,29 map:s @15,0 0x0000
door @49,24 map:se @0,18 0x0000
sprite @48,13 sprite:customer 0x00000000
