2121212121212121212121212121212121212121212121220000002021212121212121212121212121212121212121212121
3131313131311421212121212121212121212121212121220000002013313131313131313131313131313131313131313131
0000000000003031311421212121212121212121212121220000002022000000000000000000000000000000000000000000
0000000000000000003031311421212121212121212121220000002022000000000000000000000000000000000000000000
0404000000000000000000003031311421212121212121220000002022000000000000000000000000000000000000000404
1112000000000000000000000000003031311421212121220000002022000000000000000000000000000000000306011011
21220000000000000000000000000000000030313131313200000020220107010f0102020604010308010402021011112421
21220000000000000000000000000000000000000000000000000020231111121f1011111111111111111111112421212121
21220000000000000000000000000000000000000000000000000020212121221f2021212121212121212121212121212121
21220000000000000000000000000000000000000000000000000030313131321f3031313131313131313131313131313131
21220000000000000000000000000000000000000000000000000000000000001f0000000000000000000000004041424344
21220204070404020403020206010208030102020703000000000000000000001f0000000000000000000000005051525354
21231111111111111111111111111111111111111112000000000000000000001f0000000000000000000000006061626364
21212121212121211331313131313131313131311422030200000000000000001f0000000000000000010206027071727374
21212121212121212200000000000000000000002023111200000000000000001f0000000000000000101111128081828384
21212121212121212200000000000000000000003031142207010000000000001f0000000000000602202121212121212121
21212121212121212200000000000000000000000000202311120000000000001f0000000000001011242121212121212121
21212121212121212200000407000000000000000000303114220406000000001f0000000005022021212121212121212121
21212121212121212200001012000000000000000000000020231112000000001f0000000010112421212121212121212121
21212121212121212200002022000000000000000000000030311422020400001f0000030120212121212121212121212121
21212121212121212200002022000000000000000000000000002023111200001f0000101124212121212121212121212121
21212121212121212200002022000000000000000000000000003031142200001f0000202121211331313131313131313131
2121212121212121220000202200000000000000000000000000000020221516161617202121212200000000000000000000
2121212121212121220000202200000000000000000000000000000030322526262627303131313200000000000000000000
3131313131313131320000202200000000000000000000000000000000002526262627000000000000000000000000000000
0000000000000000000000202200000000000000000000000000000000002526262627000000000000000000000000000201
0000000000000000000000202200000000000000000000000000151616161616161616161617000000000000000000001011
0403040803030308010703202203030f01060302030607010502352626262626262626262637020401080303080104052021
1111111111111111111111242311121f10111111111111111111111111111111111111111111111111111111111111112421
2121212121212121212121212121221f20212121212121212121212121212121212121212121212121212121212121212121

image image:bg
sprite @46,13 sprite:hero 0x00000000
door @0,3 map:nw @39,25 0x0000
door @25,0 map:n @25,39 0x0000
door @49,3 map:ne @0,25 0x0000
door @0,26 map:sw @39,12 0x0000
door @15,29 map:s @15,0 0x0000
door @49,24 map:se @0,18 0x0000
