2e3e3e3f3e2e2d3f213f2d3e212e3e3d212e213e3d213e3f22000020213e2d3d2e2d2e3d3f3d2e3e2e2d3d3f3d2e212e212e
3131313131313131313131313131313131313131313131142200002013313131313131313131313131313131313131313131
0000000000000000000000000000000000000000000000202200002022000000000000000000000000000000000000000000
0000000000000000000000000000000000000000000000202200002022000000000000000000000000000000000000000000
0206010705070305020000000000000000000000000000202200002022000000000000000000000000000000000000000304
1111111111111111120000000000000801070205050000202200002022000000000000000000000000000000000205021011
2e133131313131313200000000000010111111111200002022000020220407040f010204070208020701040202101111242d
2d220000000000000000000000000030313131313200002022000020231111121f101111111111111111111111243d2d3d3f
21220000000000000000000000000000000000000000002022000020212e3e221f202e3f3e2e3f3f2e2d3f2e3e3f2d3d3d3f
21220000000000000000000000000000000000000000002022000020133131321f3031313131313131313131313131313131
2d220000000000040804080505020000000000000000003032000030320000001f0000000000000000000000004041424344
3e220000000000101111111111120000000000000000000000000000000000001f0000000000000000000000005051525354
21220000000000303131313131320000000000000000000000000000000000001f0000000000000000000000006061626364
2e220000000000000000000000000000000000000205030602080401060202051f0306020000000000050305027071727374
2122000000000000000000000000000000000000101111111111111111111111111111120000000000101111128081828384
3d2200000000000000000000000000000000000030313131313131313131313131313132090c0a0b0d202e3e231111111111
3e22000000000000000000000000000000000000000000000000000000000000000000000000000000303131142e3e3e3f3f
3e22030508040f04070108070700000000000000000000000000000000000000000000000000000000000000202e2e3d2d21
3d23111111121f10111111111200000000000000000000000000000000000000000000010305030802050000202d2d2d3d3d
2d213d3f3e221f203d2e3f3f2200000000000000000000000000000000000000000000101111111111120000202d3d3d2d3e
2d3f2d3e3f221f203d2e3f3f220000000000000000001a000000000000000000000000202e3e3f3f21220000202d2e2e3e3f
2e13313131321f303131311422090d000000000000002a2b2c000000001a000000000020213d212d3d220000201331313131
3f22000000001f000000002022000000000000000000000000000000002a2b2b2b2b2c20212d3d2121220000202200000000
3d22000000001f00000000202200000000000000000000000000000000000000000000202e212d2d3d220000202200000000
3132000000001f00000000202200000000000000000000000000000000000000000000303131313131320000303200000000
0000000000001f0000000020220000000000000000090c0b0b0d000000000000000000000000000000000000000000000101
0000000000001f00000000202200000000000000000000000000000000000000000000000000000000000000000000001516
0402080205041f01050802202202080f01070808040205010501030605010303050207060804060802070303060603052526
1111111111111111111111242311121f1516161616161616161616161616161616161616161616161616161616161616293a
3e2d2d2e2e3e3f2e212d213f3f2e221f2526263c3a3a3c3b3a3c3a3b3a263a3c263a3a3b3c3c263b3a3a3a3c26263c3b3b3a

image image:bg
sprite @46,13 sprite:hero 0x00000000
door @0,3 map:nw @39,25 0x0000
door @25,0 map:n @25,39 0x0000
door @49,3 map:ne @0,25 0x0000
door @0,26 map:sw @39,12 0x0000
door @15,29 map:s @15,0 0x0000
door @49,24 map:se @0,18 0x0000
sprite @48,13 sprite:customer 0x00000000
