10111111111111111111111111111111111111111111111111111111111111111111111111111112
20212113313131313131313131313131313131313131313131313131313131313131311421212122
20211332000000000000000000000000000000000000000000000000000000000000003014212122
20212200000000000000000000000000000000000000000000000000000000000000000020212122
20212200000000000000000000000000000000000000000000000000000000000000000030142122
20212200000000000000000000000000000000000000000000000000000000000000000000202122
20133200000000000000000000000000000000000000000000000000000000000000000000202122
20220000000000000000000000000000000000000000000000000000000000000000000000301422
20220000000000000000000000000000000000000000000000000000000000000000000000002022
20220000000000000000000000000000000000000000000000000000000000000000000000002022
20220000000000000000000000000000000000000000000000000000000000000000000000002022
20220000000000000000000000000000000000000000000000000000000000000000000000002022
20220000000000000000000000000000000000000000000000000000000000000000000000002022
20220000000000000000000005000500050008000500060008000000000000000000000000002022
20220000000000000000001011111111111111111111111111111112000000000000000000002022
20220000000000000000003031313131313131313131313131313132000000000000000000002022
20220000000000000000000000000000000000000000000000000000000000000000000000002022
20220000000000000000000000000000000000000000000000000000000000000000000000002022
20220000000000000000000000000000000000000000000000000000000000000000000000002022
20220000000000000000000000000000000000000000000000000000000000000000000000002022
20220000000000000000000000000000000000080005000000000055565700000000000000002022
20220000000000000000000000000000393939393938383939393945464738393939383939382022
20220000000000000000000000000000000000000000000000000000000000000000000000002022
20220000000000000000000000000000000000000000000000000000000000000000000000003032
20231200000000000000000000000000000000000000000000000000000000000000000000000000
20212200005556570000000000000000000000000000000000000000000000000000000000000000
20212238394546473939383938393938393839000000000000000000000000000000000000000000
20212200000000000000000000000000000000000000000000000000000000001011111111111112
20212200000000000000000000000000000000000000000000000000101111112421212121212122
20212200000000000000000000000000000000000000000010111111242121212121212121212122
20212200000000000000000000000000000000001011111124212121212121212121212121212122
20212200000000000000000000000000101111112421212121212121212121212121212121212122
20212200000000000000000010111111242121212121212121212121212121212121212121212122
20212200000000000000000030313131313131313131313131313131313131313131313131311422
20212200000000000000000000000000000000000000000000000000000000000000000000002022
20212200000000000000000000000000000000000000000000000000000000000000000000002022
20212200000000000000000000000000000000000000000000000000000000000000000000002022
20212205050505050505050505000505050005050500050505000000000000000000000000002022
20212311111111111111111111111111111111111111111111111111111111111111111111112422
30313131313131313131313131313131313131313131313131313131313131313131313131313132

image image:3
