10111111111111111111111111111111111111111111111111111111111111111111111111111112
20212113313131313131313131313131313131313131313131313131313131313131311421212122
20211332000000000000000000000000000000000000000000000000000000000000003014212122
20212200000000000000000000000000000000000000000000000000000000000000000020212122
20212200000000000000000000000000000000000000000000000000000000000000000030142122
20212200000000000000000000000000000000000000000000000000000000000000000000202122
20133200000000000000000000000000000000000000000000000000000000000000000000202122
20220000000000000000000000000000000000000000000000000000000000000000000000301422
20220000000000000000000000000000000000000000000000000000000000000000000000002022
20220000000000000000000000000000000000000000000000000000000000000000000000002022
20220000000000000000000000000000000000000000000000000000000000000000000000002022
20220000000000000000000000000000000000000000000000000000000000000000000000002022
20220000000000000000000000000000000000000000000000000000000000000000000000002022
20220000000000000000000000000000000000000000000000000000000000000000000000002022
20220000000000000000000000000000000000000000000000000000000000000000000000002022
20220000000000000000000000000000000000000000000000000000000000000000000000002022
20220000000000000000000000000000000000000000000000000000000000000000000000002022
20220000000000000000000000000000000000000000000000000000000000000000000000002022
20220000000000000000000000000000000000000000000000000000000000000000000000002022
20220000000000000000000000000000000000000000000000000000000000000000000000002022
20220000000000000000000000000000000000000000000000000000000000000000000000002022
20220000000000000000000000000000000000000000000000000000000000000000000000002022
20220000000000000000000000000000000000000000000000000000000000000000000000002022
20220500000000000000000000000000000000000000000000000000000000000000000000003032
20231200000000000000000000000000000000000000000000000000000000000000000000000000
20212200000000000000000000000000000000000000000000000000000000000000000000000000
20212200000000000000000000000000000000000000000000000000000000000000000000000000
20212200000000000000000000000000000000000000000000000000000000000000000000001012
20212200000000000000000000000000000000000000000000000000000000000000000000002022
20212200000000000000000000000000000000000000000000000000000000000000000000002022
20212200000000000000000000000000000000000000000000000000000000000000000000002022
20212200000000000000000000000000000000000000000000000000000000000000000000002022
20212200000000000000000000000000000000000000000000000000000000000000000000002022
20212200000000000000000000000000000000000000000000000000000000000000000000002022
20212200000000000000000000000000000000000000000000000000000000000000000000002022
20212200000000000000000000000000000000000000000000000000000000000000000000002022
20212200000000000000000000000000000000000000000000000405020108010000000000002022
20212201020604040104040406020305030102060601020302011011111111120402020704042022
20212311111111111111111111111111111111111111111111112421212121231111111111112422
30313131313131313131313131313131313131313131313131313131313131313131313131313132

image image:3
