21212121212121212121212121212121212121212121212121212121212121212121212121212121
21212121212121212113313131313131313131313131313131313131313131313131313131311421
21212121212121212122000000000000000000000000000000000000000000000000000000002021
21212121212121212122000000000000000000000000000000000000000000000000000000002021
21212121212121212122000000000000000000000000000000000000000000000000000000002021
21212121212121212122000000000000000000000000000000000000000000000000000000002021
21212121212121212122010503060105010801050307030802060107020302020300000000002021
21212121212121212123111111111111111111111111111111111111111111111200000000002021
21133131313131313131313131313131313131313131313131313131313131313200000000002021
21220000000000000000000000000000000000000000000000000000000000000000000000002021
21220000000000000000000000000000000000000000000000000000000000000000000000002021
21220000000000000000000000000000000000000000000000000000000000000000000000002021
21220000000000000000000000000000000000000000000000000000000000000000000000002021
21220000000000000000000000000000000000000000000000000000000000000000000302022021
21220000000000000000000000000000000000000000000000000000000000000000001011112421
21220000000000000000000000000000000000000000390000000000000000000000003031311421
21220000000000000000000039000000000000000000000000000000000000000000000000002021
21220038000000000000000000000000000000000000000000000000000000000000000000002021
21220000000000000000000000000000000000000000000000000000000000000000000000002021
21220000000000000000000000000000000000000000000000000000000000000000000000002021
21220000000000000000000000000000000000000000000000000000000000000000000000002021
21220000390000000000000000000000000000000000000000000000000000000000000000002021
21220000000000000000000039000000000000000000000000000000000000000000000000002021
21220000000000000000000000000000000000380000000000000000000000000000000000003031
21220000000000000000000000000000000000000000000000390000000000000000000000000000
21220000000000000000000000000000000000000000000000000000000039000000000000000000
2122000000000000000000000000000000000000000000000000000000000000000f010402020202
2122000000000000000000000000000000000000000000000000000000000000001f101111111111
2122000000000000000000000000000000000000000000000000000000000000001f202121212121
2122000000000000000000000000000000000000000000000000000000000000001f202121212121
2122000000000000000000000000000000000000000000000000000000000000001f202121212121
2122000000000000000000000000000000000000000000000000000000000000001f202121212121
2122000000000000000000000000000000000000000000000000000000000000001f202121212121
2122000000000000000000000000000000000000000000000000000000000000001f202121212121
2122000000000000000000000000000000000000000000000000000000000000001f202121212121
2122000000000000000000000000000000000000000000000000000000000000001f202121212121
2122000000000000000000000000000000000000000000000000000000000000001f202121212121
2122020705050505050505050803080507040805080208050703010401040402011f202121212121
21231111111111111111111111111111111111111111111111111111111111111111242121212121
21212121212121212121212121212121212121212121212121212121212121212121212121212121

image image:3
