2d3f3d3d3f212d3f3e2d3f3f3d3e212e2d2e3e2d2d2d2d212d2e213d3d2d2d213e3f2e2d2d2d3f3f
2e3f3e2d3f3e3d3d2d13313131313131313131313131313131313131313131313131313131311421
3e212e2d3e3d2d2d3e22000000000000000000000000000000000000000000000000000000002021
3e2d212d3d213f3d2d2200000000000000000000000000000000000000000000000000000000203e
3d2e2d3f2e2e2e2d3f2200000000000000000000000000000000000000000000000000000000203f
2d3f3e3f3f3f2d3d3e2200000000000000000000000000000000000000000000000000000000203f
3e213d3d2d3f2d212e2204060107020602080208040604060107010603030104030000000000202d
3f3f2d3f2e2d2e21212311111111111111111111111111111111111111111111120000000000203e
3e13313131313131313131313131313131313131313131313131313131313131320000000000202d
2122000000000000000000000000000000000000000000000000000000000000000000000000203d
2e22000000000000000000000000000000000000000000000000000000000000000000000000203f
3d22000000000000000000000000000000000000000000000000000000000000000000000000203e
3f22000000000000000000000000000000000000000000000000000000000000000000000000202e
3e22000000000000000000000000000000000000000000000000000000000000000000010403202d
2e22000000000000000000000000000000000000000000000000000000000000000000101111243e
3f2200000000000000000000000000000000000000000e000000000000000000000000303131143f
3d22000000000000000000000e00000000000000000000000000000000000000000000000000203d
2e22000e00000000000000000000000000000000000000000000000000000000000000000000202e
3e22000000000000000000000000000000000000000000000000000000000000000000000000203e
2e22000000000000000000000000000000000000000000000000000000000000000000000000203d
3f220000000000000000000000000000000000000000000000000000000000000000000000002021
3e2200000e000000000000000000000000000000000000000000000000000000000000000000203e
2d22000000000000000000090d00000000000000000000000000000000000000000000000000203f
3f2200000000000000000000000000000000090d0000000000000000000000000000000000003031
2d2200000000000000000000000000000000000000000000090d0000000000000000000000000000
2e22000000000000000000000000000000000000000000000000000000090d000000000000000000
2e22000000000000000000000000000000000000000000000000000000000000000f020202010402
2d22000000000000000000000000000000000000000000000000000000000000001f101111111111
3e22000000000000000000000000000000000000000000000000000000000000001f203f212e3e21
2122000000020504080601000000000000000000000000000000000000000000001f20212d3f2d21
3e22000000151616161617000000000000000000000000000000000000000000001f203e2e3e3e2e
3f22000000353636363637000000000000000000001b1d1d1c1d1e0000000000001f203d3f213e2e
3f22000000000000000000000000000000000000000000000000000000000000001f203f3d2e3e3e
3d22000000000000000000000000000000000000000000000000000000000000001f203d3e2e2e3f
2e22000000000000000000000001080305010107070301000000000000000000001f203f3e2e2d3d
2e22000000000000000000000010111111111111111112000000000000000000001f203d3e212d21
21220000000000000000000000203e2e3f2d3d3d2d3f22000000000000000000001f20212e3e2e3e
3d220108060608080806060505203f3d3d2e3d3d3e2e22070603010301040304042f203f21212121
3f231111111111111111111111242e3f2e3d3d213f3d23111111111111111111111124213d2e3f3e
213f213d3f2d3e3d3f3e2d2d2e213e3e213e3e3f3f3d3e2e2d3d2d2e2d3f3d2d2e3f2d3e2e2d3f3e

image image:3
