56565656565656565656565656565656565656565656565656565656565656565656565656572021
56565656565656565648666666666666666666666666666666666666666666666666666666672021
56565656565656565657000000000000000000000000000000000000000000000000000000002021
5656565656565656565700000000000000000000000000000000000000000000000000000000203e
5656565656565656565700000000000000000000000000000000000000000000000000000000203f
5656565656565656565700000000000000000000000000000000000000000000000000000000203f
6666666666666666666701060107020602080208040604060107010603030104030000000000202d
1111111111111111111111111111111111111111111111111111111111111111120000000000203e
2e13313131313131313131313131313131313131313131313131313131313131320000000000202d
3d22000000000000000000000000000000000000000000000000000000000000000000000000203d
2122000000000000000000000000000000000000000000000000000000000000000000000000203f
3d22000000000000000000000000000000000000000000000000000000000000000000000000203e
3f22000000000000000000000000000000000000000000000000000000000000000000000000202e
3e22000000000000000000000000000000000000000000000000000000000000000000010403202d
2e22000000000000000000000000000000000000000000000000000000000000000000101111243e
3f2200000000000000000000000000000000000000000e000000000000000000000000303131143f
3d22000000000000000000000e00000000000000000000000000000000000000000000000000203d
2e22000e00000000000000000000000000000000000000000000000000000000000000000000202e
3e22000000000000000000000000000000000000000000000000000000000000000000000000203e
2e22000000000000000000000000000000000000000000000000000000000000000000000000203d
3f220000000000000000000000000000000000000000000000000000000000000000000000002021
3e2200000e000000000000000000000000000000000000000000000000000000000000000000203e
2d22000000000000000000090d00000000000000000000000000000000000000000000000000203f
3f2200000000000000000000000000000000090d0000000000000000000000000000000000003031
2d2200000000000000000000000000000000000000000000090d0000000000000000000000000000
2e22000000000000000000000000000000000000000000000000000000090d000000000000000000
2e22000000000000000000000000000000000000000000000000000000000000000f020202010402
2d22000000000000000000000000000000000000000000000000000000000000001f101111111111
3e22000000000000000000000000000000000000000000000000000000000000001f203f212e3e21
2122000000020504080601000000000000000000000000000000000000000000001f20212d3f2d21
3e22000000151616161617000000000000000000000000000000000000000000001f203e2e3e3e2e
3f22000000353636363637000000000000000000001b1d1d1c1d1e0000000000001f203d3f213e2e
3f22000000000000000000000000000000000000000000000000000000000000001f203f3d2e3e3e
3d22000000000000000000000000000000000000000000000000000000000000001f203d3e2e2e3f
2e22000000000000000000000001080305010107070301000000000000000000001f203f3e2e2d3d
2e22000000000000000000000010111111111111111112000000000000000000001f203d3e212d21
21220000000000000000000000203e2e3f2d3d3d2d3f22000000000000000000001f20212e3e2e3e
3d220108060608080806060505203f3d3d2e3d3d3e2e22070603010301040304042f203f21212121
3f231111111111111111111111242e3f2e3d3d213f3d23111111111111111111111124213d2e3f3e
213f213d3f2d3e3d3f3e2d2d2e213e3e213e3e3f3f3d3e2e2d3d2d2e2d3f3d2d2e3f2d3e2e2d3f3e

image image:3
