10111111111111111111111111111111111111111111111111111111111111111111111111111112
20212113313131313131313131313131313131313131313131313131313131313131311421212122
20211332000000000000000000000000000000000000000000000000000000000000003014212122
20212200000000000000000000000000000000000000000000000000000000000000000020212122
20212200000000000000000000000000000000000000000000000000000000000000000030142122
20212200000000000000000000000000000508060606080707070706070505000000000000202122
20133200000000000000000000000000001011111111111111111111111112000000000000202122
20220000000000000000000000000000003031313131313131313131313132000000000000301422
20220000000000000000000000000000000000000000000000000000000000000000000000002022
20220000000000000000000000000000000000000000000000000000000000000000000000002022
20220000000000000000000000000000000000000000000000000000000000000000000000002022
20220000000000000000000000000000000000000000000000000000000000000000000000002022
20220000000000000000000000000000000000000000000000000000000000000000000000002022
20220000000000000000000606060806050706070807060506080508000000000000000000002022
20220000000000000000001011111111111111111111111111111112000000000000000000002022
20220000000000000000003031313131313131313131313131313132000000000000000000002022
20220000000000000000000000000000000000000000000000000000000000000000000000002022
20220000000000000000000000000000000000000000000000000000000000000000000000002022
20220000000000000000000000000000000000000000000000000000000000000000000000002022
20220000000000000000000000000000000000000000000000000000000000000000000000002022
20220000000000000000000000000000000000000000000000000000000000000000000000002022
20220000000000000000000000000000000000000000000000000000000000000000000000002022
20220000000000000000000000000000000000000000000000000000000000000000000000002022
20220500000000000000000000000000000000000000000000000000000000000000000000003032
20231200000000070708060708050508060608050607050805080508060607060000000000000000
20212200000000101111111111111111111111111111111111111111111111120000000000000000
20212200000000202121212121212121212121212121212121212121212121220000000000000000
20212200000000201331313131313131313131313131313131313131313131320000000000001012
20212200000000303200000000000000000000000000000000000000000000000000000000002022
20212200000000000000000000000000000000000000000000000000000000000000000000002022
20212200000000000000000000000000000000000000000000000000000000000000000000002022
20212200000000000000000000000000000000000000000000000000000000000000000000002022
20212200000000000000000000000000000000000000000000000000000000000000000000002022
20212200000000000000000000000000000000000000000000000000000000000000000000002022
20212200000000000000000000000000000000000000000000000000000000000000000000002022
20212200000000000000000000000000000000000000000000000000000000000000000000002022
20212200000000000000000000000000000000000000000000000405020108010000000000002022
20212201020604040104040406020305030102060601020302011011111111120402020704042022
20212311111111111111111111111111111111111111111111112421212121231111111111112422
30313131313131313131313131313131313131313131313131313131313131313131313131313132

image image:3
