10111111111111111111111111111111111111111111111111111111111111111111111111111112
20133131313131313131313131313131313131313131313131313131313131313131313131311422
20220000000000000000000000000000000000000000000000000000000000000000000000002022
20220000000000000000000000000000000000000000000000000000000000000000000000002022
20220000000000000000000000000000000000000000000000000000000000000000000000002022
20220000000000000000000000000000000000000000000000000000000000000000000000002022
20220000000006060808060808080805050705060705060705070605060808060606070000002022
20220000000010111111111111111111111111111111111111111111111111111111120000002022
20220000000030313131313131313131142121211331313131313131313131313131320000002022
20220000000000000000000000000000303131313200000000000000000000000000000000002022
20220000000000000000000000000000000000000000000000000000000000000000000000002022
20220000000000000000000000000000000000000000000000000000000000000000000000002022
20220000000000000000000000000000000000000000000000000000000000000000000000002022
20220000000000000000000000000000000000000000000000000000000000000000000000002022
20220000000000000000000000000000000000000000000000000000000000000000000000002022
20220000000000000000000000000000000000000000000000000000000000000000000000002022
20220000000000000000000000000000000000000000000000000000000000000000000000002022
20220807060607050808070806080706000000000000000000000000000000000000000000002022
20231111111111111111111111111112000000000000000000000000000000000000000000002022
20133131313131313131313131313132000000000000000000000000000000000000000000002022
20220000000000000000000000000000000000000000000000000000000000000000000000002022
20220000000000000000000000000000000000000000000507060607070508080705080706082022
20220000000000000000000000000000000000000000001011111111111111111111111111112422
20220000000000000000000000000000000000000000003031313131313131313131313131311422
20220000000000000000000000000000000000000000000000000000000000000000000000002022
20220000000006070506080706080506060705000000000000000000000000000000000000002022
20220000000010111111111111111111111112000000000000000000000000000000000000002022
20220000000030313131313131313131313132000000000000000000000000000000000000002022
20220000000000000000000000000000000000000000000000000000000000000000000000002022
20220000000000000000000000000000000000000000000000000000000000000000000000002022
20220804040205010402040405020205030306020403050400000001040503020601020205012022
20231111111111111111111111111111111111111111111200000010111111111111111111112422
20212121212121212121212121212121212121212121212200000020212121212121212121212122
20212121212121212121212121212121212121212121212200000020212121212121212121212122
20212121212121212121212121212121212121212121212200000020212121212121212121212122
20212121212121212121212121212121212121212121212200000020212121212121212121212122
20212121212121212121212121212121212121212121212200000020212121212121212121212122
20212121212121212121212121212121212121212121212200000020212121212121212121212122
20212121212121212121212121212121212121212121212200000020212121212121212121212122
30313131313131313131313131313131313131313131313200000030313131313131313131313132

image image:3
