10111111111111111111111111111111111111111111111111111111111111111111111111111112
20133131313131313131313131313131313131313131313131313131313131313131313131311422
20220000000000000000000000000000000000000000000000000000000000000000000000002022
20220000000000000000000000000000000000000000000000000000000000000000000000002022
20220000000000000000000000000000000000000000000000000000000000000000000000002022
20220000000000000000000000000000000000000000000000000000000000000000000000002022
20220000000010111111111111111111111111111111111111111111111111111111120000002022
20220000000020212121212121212121212121212121212121212121212121212121220000002022
20220000000030313131313131313131142121211331313131313131313131313131320000002022
20220000000000000000000000000000303131313200000000000000000000000000000000002022
20220000000000000000000000000000000000000000000000000000000000000000000000002022
20220000000000000000000000000000000000000000000000000000000000000000000000002022
20220000000000000000000000000000000000000000000000000000000000000000000000002022
20220000000000000000000000000000000000000000000000000000000000000000000000002022
20220000000000000000000000000000000000000000000000000000000000000000000000002022
20220000000000000000000000000000000000000000000000000000000000000000000000002022
20220000000000000000000000000000000000000000000000000000000000000000000000002022
20220000000000000000000000000000000000000000000000000000000000000000000000002022
20220000000000000000000000000000000000000000000000000000000000000000000000002022
20220000000000000000000000000000000000000000000000000000000000000000000000002022
20220000000000000000000000000000000000000000000000000000000000000000000000002022
20220000000000000000000007000800050000555657000600060005000800050008000000002022
20231111111111111111111111111111111112454647101111111111111111111111111111112422
20133131313131313131313131313131313132000000303131313131313131313131313131311422
20220000000000000000000000000000000000000000000000000000000000000000000000002022
20220000000000000000000000000000000000000000000000000000000000000000000000002022
20220000000015161616161616161616161616161616170000000000000000000000000000002022
20220000000025262626262626262626262626262626270000000000000000000000000000002022
20220000000035363636363636363636363636363636370000000000000000000000000000002022
20220000000000000000000000000000000000000000000000000000000000000000000000002022
20220505050500050505050005050505000505050500000000000000000005050500000000002022
20231111111111111111111111111111111111111111111200000010111111111111111111112422
20212121212121212121212121212121212121212121212200000020212121212121212121212122
20212121212121212121212121212121212121212121212200000020212121212121212121212122
20212121212121212121212121212121212121212121212200000020212121212121212121212122
20212121212121212121212121212121212121212121212200000020212121212121212121212122
20212121212121212121212121212121212121212121212200000020212121212121212121212122
20212121212121212121212121212121212121212121212200000020212121212121212121212122
20212121212121212121212121212121212121212121212200000020212121212121212121212122
30313131313131313131313131313131313131313131313200000030313131313131313131313132

image image:3
