21212121212121212121212121212121212121212121212121212121212121212121212121212121
21212121212121212121212121212121212121212121212121212121212121212121212121212121
21212121212121212121212121212121212121212121212121212121212121212121212121212121
21212121212121212121212121212121212121212121212121212121212121212121212121212121
21212121212121212121212121212121212121212121212121212121212121212121212121212121
21212121212121212121212121212121212121212121212121212121212121212121212121212121
21133131313131313131313131313131313114212121212121212121212121212121212121212121
21220000000000000000000000000000000020212121212121212121212121212121212121212121
21220000000000000000000000000000000020212121212121212121212121212121212121212121
21220000000000000000000000000000000020212121212121212121212121212121212121212121
21220000000000000000000000000006060520212121212121212121212121212121212121212121
21220000000000000000000000000010111124211331313131313131311421212121212121212121
21220000000000000000000000000020212121212200000000000000002021212121212121212121
21220000000000000000040302000030313131313200000000000000003031313131313131311421
21220407080708050501101112000000000000330000000000000000000000000000000000002021
21231111111111111112303132000000000000003400000000000000000000000000000000002021
21212121212121212122000000003939000000000000000000000000000000000000000000002021
21212121212121212122000000000000000000000000000000000000000000000000000000002021
21212121212121212122000000000000000000000000000203010000000000000000000000002021
21212121212121212122000000000000000000000000003333340403000000000000000000002021
21212121212121212122000000000000000000000000000000001012000000000000000000002021
21212121212121212122000000000000000000000000000000002022000000000000000000002021
21212121212121212122040303030203020404040102030606062022000000000000000000002021
21212121212121212123111111111111111111111111111111112422050200000000000000002021
21212121212121212121212121212121212121212121212121212123111200000000000000002021
21212121212121212121211331313131313131313131313131313131313200000000000000002021
21212121212121212121212200000000000000000000000000000000000000000000000000002021
21212121212121212121212200000000000000000000000000000000000000000001050605042021
21212121212121212121212200000000000000000000000000000000000000000010111111112421
21212121212121212121212200000000000000000000000000000000000000000020212121212121
21212121212121212121212208050506030505050707040301000001040105050520212121212121
21212121212121212121212311111111111111111111111112000010111111111124212121212121
21212121212121212121212121212121212121212121212122000020212121212121212121212121
21212121212121212121212121212121212121212121212122000020212121212121212121212121
21212121212121212121212121212121212121212121212122000020212121212121212121212121
21212121212121212121212121212121212121212121212122000020212121212121212121212121
21212121212121212121212121212121212121212121212122000020212121212121212121212121
21212121212121212121212121212121212121212121212122000020212121212121212121212121
21212121212121212121212121212121212121212121212122000020212121212121212121212121
21212121212121212121212121212121212121212121212122000020212121212121212121212121

image image:3
sprite @21,22 sprite:squishroom (u8:flag)nsquishroom 0x000000
