3e2d213f3e2d2d3d3f3e2d213f21213f3f2d2e21213d2e3d2e3d3f212e3d3e3e3d2d3d21212e2e3e
2e2e3d213d2d3d3e2d2d2e3d3d3d2e3e2e2e3d3d2d2d3e213f3d2e2d2d3e3f2d3d3e2e2d2e3f2d3e
2e213d213f212d2e3e3f3d3f3d2d21212e21213d213e3e3d3f2e212d21212e212d2d3f213e3f2d21
2121212d2d2d2e2d3f3f2d2e2e3e2e2d3f3d212d3f2e2e212d3d3e3d3e212d3d3e2e2e3e3e3d2e3e
2d3f2d3f212e3f3d3e3f3e3d3f21212d2d3d2d3f2d3e2e3f2e3d2d3f3d3f2d3e3f3f3e2d212d3f21
2d2e2d3d213d2d3d2e3f3f3d3e2e3d3d3f2d3d2d2e3f2d21213d2e3d2d2e3f2e2d3e212d3f2d3d2d
211331313131313131313131313131313131142e2e212e3d3f3d2d3e213d2e2e213e3d3d3e2d3d3f
2d2200000000000000000000000000000000202e3f3d3f3d3f3f3d2d213e212e213f2d3f2e3d3f3f
3d220000000000000000000000000000000020213d3d3d2d2d3d212d212d3f2e3d3e3e3d3f3d2e3e
3e2200000000000000000000000000000000203f2d212d2e3e3d3f212e3d21213d2d2d3d2e3f3d3f
3d2200000000000000000000000000060706203e2e2e3d2e3e2d3f3f3e2d3d3f212e3f213d3f212d
212200000000000000000000000000101111243f133131313131313131143f2e2e3e2e3e2e212d3f
2d2200000000000000000000000000203e3d2e3f220000000000000000202d2e3f2e2e3f3f213f3e
2e22000000000000000003040400003031313131320000000000000000303131313131313131143e
2e22020707050808060415161700000000000033000000000000000000000000000000000000203f
2e23111111111111111235363700000000000000340000000000000000000000000000000000202e
3d2e2d2e3e213d212d2200000000090d00000000000000000000000000000000000000000000203d
2e3d3f3d2d3d2e213e2200000000000000000000000000000000000000000000000000000000203d
2d3e3d2d3d212d2e2d2200000000000000000000000000040302000000000000000000000000203f
3d2e3f213f3f3d3f3f2200000000000000000000000000343433040300000000000000000000203d
2d3e3f2d213d2d213e2200000000000000000000000000000000101200000000000000000000202d
3d213d3f3f3d3e3e2d2200000000000000000000000000000000202200000000000000000000202e
3e212e3e3d3d2e3e2d2203040102030403040103010202050706202200000000000000000000203f
2e3d212e3d2e3e213d23111111111111111111111111111111112422080300000000000000002021
213e3d2e2e3d3d2e2d2d3d3d3f2e213e2d3e3f212e213e2e3e2e3d2311120000000000000000202d
2d3e3e2e2d212e2d3e2d211331313131313131313131313131313131313200000000000000002021
3f3e3e2d212e2e2e2e3f3f220000000000000000000000000000000000000000000000000000203d
3e2e3e3e3f2d2e213f3e2d220000000000000000000000000000000000000000000208050602203e
2e212d213e3d212d3e3e3f220000000000000000000000000000000000000000001011111111243d
3f3d3e3d3d2d2d3d2e213e22000000000000000000000000000000000000000000202d3e213f3d3f
3e2e3d3e2e3e2e3d3f213f22060606050108050506050401030000010301060507203d3e213e3e21
213e2e3f3d3d3f3d21213d23111111111111111111111111120000101111111111243d3f2d3d2e3d
3f2d212e213d2e3e2e3e3e213e3f3f2e2d3f212d21213d3f220000203d2d3e3d3f2e3f3e213e3e3d
3d213d2d3f2d2e213d2d213e213f213d212e2e3d3e3d3f3e220000202e2e3d2e2e212e2e3f3d2d2e
3d3e2d2d3f3f3f2d213f2e3f212e2d3e3f213f213d212e3e220000202d212e3d213d3d2e213f3d2e
2e3e3f3f2e213f2e213f2d3d2d3f3f3f3e213d3e3d2d2e3e22000020212e2d2e21213f2d3f3d3e2e
3f3e3e3d212d3f2e3d3f3d2d2e3e3d2e213e2e212d3f2e2e2200002021212d2e2d2d3d3e21212d2e
3f213f3d213f2d3e213d3d3d2d2d212e3f2d2d212d3f2d3e220000203d3f3d2d3f2d2d2e3d2e2e3f
3f213d212d3e3d3e3e2d21213f3d3e2d3d3e2d3e21213d3d220000203d3d2e2e213f2e2d213e3f3d
2e3d2d3e2e3f2e2d212d3d3f213d3e213f3d213d3e3d2e3d220000203d2d3f3f3e3f3d2e213f212d

image image:3
sprite @21,22 sprite:squishroom (u8:flag)nsquishroom 0x000000
