10111111111111111111111111111111111111111111111111111111111111111111111111111112
20133131313131313131313131313131313131313131313131313131313131313131313131311422
20220000000000000000000000000000000000000000000000000000000000000000000000002022
20220000000000000000000000000000000000000000000000000000000000000000000000002022
20220000000000000000000000000000000000000000000000000000000000000000000000002022
20220000000000000000000000000000000000000000000000000000000000000000000000002022
20220000000000000000000000000000000000000000000000000000000000000000000000002022
20220000000000000000000000000000000000000000000000000000000000000000000000002022
20220000000000000000000000000000000000000000000000000000000000000000000000002022
20220000000000000000000000000000000000000000000000000000000000000000000000002022
20220000000000000000000000000000000000000000000000000000000000000000000000002022
20220000000000000000000000000000000000000000000000000000000000000000000000002022
20220000000000000000000000000000000000000000000000000000000000000000000000002022
20220000000000000000000000000000000000000000000000000000000000000000000000002022
20220000000000000000000000000000000000000000000000000000000000000000000000002022
20220000000000000000000000000000000000000000000000000000000000000000000000002022
20220000000000000000000000000000000000000000000000000000000000000000000000002022
20220000000000000000000000000000000000000000000000000000000000000000000000002022
20220000000000000000000000000000000000000000000000000000000000000000000000002022
20220000000000000000000000000000000000000000000000000000000000000000000000002022
20220000000000000000000000000000000000000000000000000000000000000000000000002022
20220000000000000000000000000000000000000000000000000000000000000000000000002022
20220000000000000000000000000000000000000000000000000000000000000000000000002022
30320000000000000000000000000000000000000000000000000000000000000000000000002022
00000000000000000000000000000000000000000000000000000000000000000000000000002022
00000000000000000000000000000000000000000000000000000000000000000000000000002022
04020503040801030000000000000000000000000000000000000000000000000000000000002022
10111111111111120500000000000000000000000000000000000000000000000000000000002022
20212121212121231202020000000000000000000000000000000000000000000000000000002022
20212121212121212311120300000000000000000000000000000000000000000000000000002022
20212121212121212121231207000000000000000000000000000000000000000000000000002022
20212121212121212121212312010000000000000000000008050508000000000000000000002022
20212121212121212121212123120300000000000000000010111112000000000000000000002022
20212121212121212121212121231203000000000000000030313132000000000000000000002022
20212121212121212121212121212312060000000000000000000000000000000000000000002022
20212121212121212121212121212123120200000000000000000000000000000000000000002022
20212121212121212121212121212121231200000000000000000000000000000000000000002022
20212121212121212121212121212121212201020701030107040105020205030205030603022022
20212121212121212121212121212121212311111111111111111111111111111111111111112422
30313131313131313131313131313131313131313131313131313131313131313131313131313132

image image:3
