10111111111111111111111111111111111111111111111111111111111111111111111111111112
20133131313131313131313131313131313131313131313131313131313131313131313131311422
20220000000000000000000000000000000000000000000000000000000000000000000000002022
20220000000000000000000000000000000000000000000000000000000000000000000000002022
20220000000000000000000000000000000000000000000000000000000000000000000000002022
20220000000000000000000000000000000000000000000000000000000000000000000000002022
20220000000000000000000000000000000000000000000000000000000000000000000000002022
20220000000000000000000000000000000000000000000000000000000000000000000000002022
20220000000000000000000000000000000000000000000000000000000000000000000000002022
20220000000000000000000000000000000000000000000000000000000000000000000000002022
20220000000000000000000000000000000000000000000000000000000000000000000000002022
20220000000000000000000000000000000000000000000000000000000000000000000000002022
20220000000000000000000000000000000000000000000000000000000000000000000000002022
20220000000000000000000000000000000000000000000000000000000000000000000000002022
20220000000000000000000000000000000000000000000000000000000000000000000000002022
20220000000000000000000000000000000000000000000000000000000000000000000000002022
20220000000000000000000000000000000000000000000000000000000000000000000000002022
20220000000000000000000000000000000000000000000000000000000000000000000000002022
20220000000000000000000000000000000000000000000000000000000000000000000000002022
20220000000000000000000000000000000000000000000000000000000000000000000000002022
20220000000000000000000000000000000000000000000000000000000000000000000000002022
20220000000000000000000000000000000000000000000000000000000000000000000000002022
20220000000000000000555657000000000000000000000000000000000000000000000000002022
30320000000000000000000000000800070006000700060008000500080005000000000000002022
00000000000000000000003838393938393939383839393838393939393839393838393939382022
00000000000000000000000000000000000000000000000000000000000000000000000000002022
00000000000000000000454647000000000000000000000000000000000000000000000000002022
10111111111111120000000000000000000000000000000000000000000000000000000000002022
20212121212121231200000000000000000000000000000000000000000000000000000000002022
20212121212121212311120000000000000000000000000000000000000000000000000000002022
20212121212121212121231200000000000000000000000000000000000000000000000000002022
20212121212121212121212312000000000000000000000006060606000000000000000000002022
20212121212121212121212123120000000000000000000010111112000000000000000000002022
20212121212121212121212121231200000000000000000030313132000000000000000000002022
20212121212121212121212121212312000000000000000000000000000000000000000000002022
20212121212121212121212121212123120000000000000000000000000000000000000000002022
20212121212121212121212121212121231200000000000000000000000000000000000000002022
20212121212121212121212121212121212200060606060006060606000606060600060606002022
20212121212121212121212121212121212311111111111111111111111111111111111111112422
30313131313131313131313131313131313131313131313131313131313131313131313131313132

image image:3
