2d3f3f3d2d2e3f3e3f3f213d3e3d3f3e3f2d3d3d3e2e3f3f3e3f3e2d2e212d2e2e212121213e2d21
3f213e3f3e2e3f2e2d2d2d3e2d3d3d212d3d3d2e3e213d3e212d3d3f3d21212d3f212d2e3e3d2d2d
212e212121212e3d2e2e3f213d3f3f3f2d2d3e2d3f3d3e2d2d3f3e2d3f2d3e2e2d3e3f212e3e3f21
212e3f3e2e3f3d3d3d3e21213d3d2d2e2e2d212e2d2d3f212d3f2d3f2e3e3e3d3d2d2d3f2121213d
2e2e3f2d2d3d2e2e3e2d2e3f3f3d2e3f2e3e2d2d3e3e213f2e3f2e212d2d213d2e2e2d3e2e3d213f
2e3f2e3f2d212d3e3e3f2e3d3d2d3e2d2d21212e2e213d3f3e2d3e2e3e213e2e3f3f3d212d2e2e2e
213f3f3f3f3d2e21213f3d3f2e21133131313131313131313131313131313131313131313131142d
3f213f3e2d21212e3e2d3e3e3e2e220000000000000000000000000000000000000000000000202d
2d3d213f3e3f3f2d3e3d2d3f3d3f2200000000000000000000000000000000000000000000002021
3d3f2d3e2e3f3f3d3f3e3e213d3d220000000000000000000000000000000000000000000000202e
213f3e3e21213f3f3e3d2e2d213e220000000000000000000000000000000000000000000000203f
3f3e3e2e212d2d212d2d3d213d3e220000000000000000000000000302020300000000000000202e
3d2d2e3e3d2d2e3d2d2d3d2d3d3e2200000000000000000000000010111112000000000000002021
3f3d2d3d3f2d3d2d2d2d212e3d2d22000000000000000000000000203e3e2200000000000000203d
3f3f3d3f21213e2d3f3d2d213d3e22000000000000000000000000203e3f2200000303080104203e
2e3e3d3d3f2d3d3e2121213e2e3f22000000000000000000000000203d1332000034343334332021
212e2e2e2d2e2d2d2e213d3d2d2d2200000000000000000000000020212200000000000000002021
2e2e3e3f213d2d2d3d3d2e3e213d220000000000000000000000002021220000000000000000203f
3d2d2e213d3e3e2e2d212e2e2e2e220000000000000000000000002021220000000000000000203d
3d3e2d3e3f3e2d2e3d3e213d212e22000000000000000000000000203d220000000000000000203d
3d3d2e2e212d3e2d2e2e3d2e3f3f22000000000000000000000000203e220000000000000000203f
2e2d2d3d213f2d3d212121212e2122000001020501050108030000202e220605080800000206202d
3e212d213d2d21213e2d2e2d2d3d22000015161616161616170000203e231111111200001011242e
313131313131313131142d213d2d2200002526263a3c3c3c270000203d213e2121220000203e2121
000000000000000000203f3d3d2e220000253c3c3b3c3a3a270000203f3f3d3d3e220000203e3f2e
000000000000000000203e3f2d3e2200003536363636361927000020133131313132000030313114
010303030000000000203d3f2e2e2200000000000000002527000020220000000000000000000020
11111112000000000030313131313200000000000000003537000030320000000000000000000020
213f3e22000000000000000000000000000000000000000000000000000000000000000000000020
2d2e2d22000000000000000000000000000000000000000000000000000000000000000000000020
2d3f3e22000000000000000000000000000000000000000000000000000000000000000000000020
3d212d22000000000000000001080100000000000000000000000000000000000000000000000020
3f212122000000000000000015161700000000000000001a05060607000000000000000000000020
3e2e3e220000000000000000253a2700000000000000002a2b2b2b2c000000000000000102020220
3f2d3e220202010405050707253a2701050400000000000000000000000000000000001011111124
3e2e21231111111111111112253b271011120000000000000000000000000000040302202d2e3d21
2e3f3f2e3f2e3f3f3d2d2122253a27202122000000000000000000000000000010111124213f3f2d
2121213d2d213f3d2e2d2e22253c27203e220408010607010606080501050105203d3e3f3f3f2e3d
2e213e2d2d213f3d3e3e2e22253a27203e231111111111111111111111111111242d2d2d3f213d3e
3e2e3e212d2e2d3d3f2d2e22253b27203e3f3d2d3f3e3e3f3f3f213e3d3e2e3f3f3e2e2e2d3e3d3e

image image:3
sprite @5,34 sprite:goat 0x00000000
sprite @32,21 sprite:goat 0x00000000
sprite @30,16 sprite:flamethrower (u8:flag)neflame 0x501300
sprite @28,11 sprite:treadle (u8:flag)neflame 0x000000
