10111111111111111111111111111111111111111111111111111111111111111111111111111112
20133131313131313131313131313131313131313131313131313131313131313131313131311422
20220000000000000000000000000000000000000000000000000000000000000000000000002022
20220000000000000000000000000000000000000000000000000000000000000000000000002022
20220000000000000000000000000000000000000000000000000000000000000000000000002022
20220000000000000000000000000000000000000000000000000000000000000000000000002022
20220000000000000000000000000000000000000000000000000000000000000000000000002022
20220000000000000000000000000000000000000000000000000000000000000000000000002022
20220000000000000000000000000000000000000000000000000000000000000000000000002022
20220000000000000000000000000000000000000000000000000000000000000000000000002022
20220000000000000000000000000000000000000000000000000000000000000000000000002022
20220000000000000000000000000000000000000000000000000000000000000000000000002022
20220000000000000000000000000000000000000000000000000000000000000000000000002022
20220000000000000000000000000000000000000000000000000000000000000000000000002022
20220000000000000000000000000000000000000000000000000000000000000000000000002022
20220000000000000000000000000000000000000000000000000000000000000000000000002022
20220000000000000000000000000000000000000000000000000000000000000000000000002022
20220000000000000000000000000000000000000000000000000000000000000000000000002022
20220000000000000000000000000000000000000000000000000000000000000000000000002022
20220000000000000000000000000000000000000000000000000000000000000000000000002022
20220000000000000000000000000000000000000000000000000000000000000000000000002022
20220000000000000000000000000000000000000000000000000000000000000000000000002022
20220000000000000000000000000000000000000000000000000000000000000000000000002022
30320000000000000000000000000000000000000000000000000000000000000000000000002022
00000000000000000000000000000000000000000000000000000000000000000000000000002022
00000000000000000000000000000000000000000000000000000000000000000000000000002022
04010303010404030000000000000000000000000000000000000000000000000000000000002022
10111111111111120400000000000000000000000000000000000000000000000000000000002022
20212121212121231203020000000000000000000000000000000000000000000000000000002022
20212121212121212311120100000000000000000000000000000000000000000000000000002022
20212121212121212121231201000000000000000000000000000000000000000000000000002022
20212121212121212121212312020000000000000000000000000000000000000000000000002022
20212121212121212121212123120300000000000000000000000000000000000000000000002022
20212121212121212121212121231201000000000000000000000000000000000000000000002022
20212121212121212121212121212312040000000000000000000000000000000000000000002022
20212121212121212121212121212123120100000000000000000000000000000000000000002022
20212121212121212121212121212121231200000000000000000000000000000000000000002022
20212121212121212121212121212121212201040102030102030401010401030104010204022022
20212121212121212121212121212121212311111111111111111111111111111111111111112422
30313131313131313131313131313131313131313131313131313131313131313131313131313132

image image:3
