21212121212121212121212121212121212121212121212121212121212121212121212121212121
21212121212121212121212121212121212121212121212121212121212121212121212121212121
21212121212121212121212121212121212121212121212121212121212121212121212121212121
21212121212121212121212121212121212121212121212121212121212121212121212121212121
21212121212121212121212121212121212121212121212121212121212121212121212121212121
21212121212121212121212121212121212121212121212121212121212121212121212121212121
21212121212121212121212121211331313131313131313131313131313131313131313131311421
21212121212121212121212121212200000000000000000000000000000000000000000000002021
21212121212121212121212121212200000000000000000000000000000000000000000000002021
21212121212121212121212121212200000000000000000000000000000000000000000000002021
21212121212121212121212121212200000000000000000000000000000000000000000000002021
21212121212121212121212121212200000000000000000000000003010403000000000000002021
21212121212121212121212121212200000000000000000000000010111112000000000000002021
21212121212121212121212121212200000000000000000000000020212122000000000000002021
21212121212121212121212121212200000000000000000000000020212122000004020603022021
21212121212121212121212121212200000000000000000000000020211332000034343333332021
21212121212121212121212121212200000000000000000000000020212200000000000000002021
21212121212121212121212121212200000000000000000000000020212200000000000000002021
21212121212121212121212121212200000000000000000000000020212200000000000000002021
21212121212121212121212121212200000000000000000000000020212200000000000000002021
21212121212121212121212121212200000000000000000000000020212200000000000000002021
21212121212121212121212121212200000401050306010701000020212207050805000003052021
21212121212121212121212121212200001011111111111112000020212311111112000010112421
31313131313131313114212121212200002021212121212122000020212121212122000020212121
00000000000000000020212121212200002021212121212122000020212121212122000020212121
00000000000000000020212121212200003031313131311422000020133131313132000030313114
01020102000000000020212121212200000000000000002022000020220000000000000000000020
11111112000000000030313131313200000000000000003032000030320000000000000000000020
21212122000000000000000000000000000000000000000000000000000000000000000000000020
21212122000000000000000000000000000000000000000000000000000000000000000000000020
21212122000000000000000000000000000000000000000000000000000000000000000000000020
21212122000000000000000003070100000000000000000006060606000000000000000000000020
21212122000000000000000010111200000000000000000010111112000000000000000000000020
21212122000000000000000020212200000000000000000030313132000000000000000301020120
21212122040402040605070820212202060200000000000000000000000000000000001011111124
21212123111111111111111124212311111200000000000000000000000000000404032021212121
21212121212121212121212121212121212200000000000000000000000000001011112421212121
21212121212121212121212121212121212201060406080206060608030603052021212121212121
21212121212121212121212121212121212311111111111111111111111111112421212121212121
21212121212121212121212121212121212121212121212121212121212121212121212121212121

image image:3
sprite @5,34 sprite:goat 0x00000000
sprite @32,21 sprite:goat 0x00000000
sprite @30,16 sprite:flamethrower (u8:flag)neflame 0x501300
sprite @28,11 sprite:treadle (u8:flag)neflame 0x000000
