10111111111111111111111111111111111111111111111111111111111111111111111111111112
20133131313131313131313131313131313131313131313131313131313131313131313131311422
20220000000000000000000000000000000000000000000000000000000000000000000000002022
20220000000000000000000000000000000000000000000000000000000000000000000000002022
20220000000000000000000000000000000000000000000000000000000000000000000000002022
20220000000000000000000000000000000000000000000000000000000000000000000000002022
20220000000000000000000000000000000000000000000000000000000000000000000000002022
20220000000000000000000000000000000000000000000000000000000000000000000000002022
20220000000000000000000000000000000000000000000000000000000000000000000000002022
20220000000000000000000000000000000000000000000000000000000000000000000000002022
20220000070007000800060005000700070005000800555657000000000000000000000000003032
20220015161616161616161616161616161616161616161700000000000000000000000000000000
20220035363636363636363636363636363636363636363745464700000000000000000000000000
20220000000000000000000000000000000000000000000000000000000000000000000000000000
20220000000000000000000000000000000000000000000000000000000010111111111111111112
20220000000000000000000000000000000000000000000000000000000020212121212121212122
20220005080808000808080800080808080008080808000808080000000020212121212121212122
20231111111111111111111111111111111111111111111111111111111124212121212121212122
20212121212121212121212121212121212121212121212121212121212121212121212121212122
20212121212121212121212121212121212121212121212121212121212121212121212121212122
20212121212121212121212121212121212121212121212121212121212121212121212121212122
20212121212121212121212121212121212121212121212121212121212121212121212121212122
20212121212121212121212121212121212121212121212121212121212121212121212121212122
20212121212121212121212121212121212121212121212121212121212121212121212121212122
20212121212121212121212121212121212121212121212121212121212121212121212121212122
20212121212121212121212121212121212121212121212121212121212121212121212121212122
20212121212121212121212121212121212121212121212121212121212121212121212121212122
20212121212121212121212121212121212121212121212121212121212121212121212121212122
20212121212121212121212121212121212121212121212121212121212121212121212121212122
20212121212121212121212121212121212121212121212121212121212121212121212121212122
20212121212121212121212121212121212121212121212121212121212121212121212121212122
20212121212121212121212121212121212121212121212121212121212121212121212121212122
20212121212121212121212121212121212121212121212121212121212121212121212121212122
20212121212121212121212121212121212121212121212121212121212121212121212121212122
20212121212121212121212121212121212121212121212121212121212121212121212121212122
20212121212121212121212121212121212121212121212121212121212121212121212121212122
20212121212121212121212121212121212121212121212121212121212121212121212121212122
20212121212121212121212121212121212121212121212121212121212121212121212121212122
20212121212121212121212121212121212121212121212121212121212121212121212121212122
30313131313131313131313131313131313131313131313131313131313131313131313131313132

image image:3
