3f2d3d3d3e3e2e3d213e213d3d3e2d3e2d2d3f3e3d213e2d2e21212e3f2e3f2e3e3e3d213f3d2d3e
3e2d3e1331313131313131313131313131313131313131313131313131143e2e2d2d2e2d3f3f2e2d
2e2d3d2200000000000000000000000000000000000000000000000000202d213f3e213e2e3f2d3e
212e3e2200000000000000000000000000000000000000000000000000203e2d212e2e2e213f2d3f
3d3f2d220000000000000000000000000000000000000000000000000020213f3e3e2d2e3f2d212d
2d3f3f2200000000000000000201010403010102000000000000000000202d2e2d3e213f2e213f3d
2d2e3e2200000000000000001011111111111112000000000000000000202e3e3f3f3d3e2d3e3d3f
3e213f220000000000000000202e2e2e212d2d22000000000000000000203d2e2d3e3e3f3e3f3d2d
2e2e2d22000000000000000020212d3e2e2d2d2200000000000000000020212d2e212d2d213d213f
13313132000000000000000030143d3f2e2d2d22000000000000000000203f3f213e2d3f2d3e3d3e
22000000000000000000000000202e3d3f213f220000000000000000002013313131313131313131
22000000000000000000000000202d3f3f3f3e220000000000000000002022000000000000000000
22000000000000000000000000202e3e2d3d3f220606050607080705082022000000000000000000
2200000000000000000000000030143e3f2d2d231111111111111111112422000000000106040203
2200000000000000000000000000202d3f2d213f3e3d133131313131313132000000001011111111
2200000000000000000000000000203f21212d212d3d22000000000000000000000000202d3e3f2e
2200000000000000000000000000202d3d3d3e3f133132000000000000000000000306203d3d2e2d
220000000000000000000000000030143e2e212e220000000000000000000000001011242d213f3e
220000000000000000000000000000203e212e1332000000000000000000000604203f3f3f2d3e21
220000000000000000000000000000203e2e3d220000000000000000000000101124212d213d3d2e
220000000000000000000000000000203e2d2122000000000000000000010820213f2e2d3e3f2121
22000000000000000000000000000030143e21220000000000000000001011243d3e2d3e21213d21
22000000000000000000000000000000203f3f22000000000000000101203d3f3d2e3d3e2d213f21
22000000000000000000000000000000202e3d220000000000000010112421213d2e2e3d21212e2d
2200000000000000000000000000000020213d220000000000020620213d3d3f2e3d213d3e3e2d3e
2200000000000000000000000000000030143e2200000000001011243f3d2e3e2d3e212e2e2d3e2e
2200000000000000000000000000000000202d220000000000203e2d3e3e3f2d3d213e2e213e3e3e
2200000000000000000000000000000000203f220000000000203d2e213f3f3d213e3e2d212d3d2e
2200000000000000000000000000000000202d2200000001032021212d2d212e3f3f3d3d3d213f2d
22000000000000000000000000000000003031320000001011243e2e213f3d3f2e2d3f3e3d3e3d21
220000000000000000000000000000000000000000000020213f3f3d3e213f2e2d213d2e3f213d3f
220000000000000000000000000000000000000000000020212d213f213f213f213d3f3f3d3f2e21
2201060508070308050607020408080603050305040803203e2e212e3d3f3f3d3e213d212e21213f
231111111111111111111111111111111111111111111124213e2d2d2d2d2d3d2e3d3f212d2d2e3e
213e3e2d2e2d3e2d213d3d2d3f3f2e212e21213d2d3d3f212e3e2d3f3e3d2d3d213e3e2e2d2e213d
3f3e2d3d212e3f21213e2e2d3d3e213e213e3f2d3e3e3e3d3e3d3d3f3f213d3d3e3e3f2e3e2e2e3d
3d3d3e3f213d2d3e21212d3d3e2d3f3f3f3f3e3e212d2d2e21212d3e3f3f3e3d2d2e212d3f3f3e2e
3d2e2e2e21212e3e3e3e3f3d2121212e2e3e3e2d3f2121212e2e3e3f3f2e2e2d2d2d21213f2d3e21
2e3e2e3d3e3d2121212e3f2d212d2e2d3d3f2e3f3d213e2e3d3f212d3d2e2e3f3d3d213e2e2d2d21
3d2d3f3f21212d3d2d2d3e3f2e2d3d2e213e21212d2e212e3f3e2d3e3e21212d2d3d2d2d3f3d2e2d

image image:3
