10111111111111111111111111111111111111111111111111111111111111111111111111111112
20133131313131313131313131313131313131313131313131313131313131313131313131311422
20220000000000000000000000000000000000000000000000000000000000000000000000002022
20220000000000000000000000000000000000000000000000000000000000000000000000002022
20220000000000000000000000000000000000000000000000000000000000000000000000002022
20220000000000000000000000000000000000000000000000000000000000000000000000002022
20220000000000000000000000000000000000000000000000000000000000000000000000002022
20220000000000000000000000000000000000000000000000000000000000000000000000002022
20220000000000000000000000000000000000000000000000000000000000000000000000002022
20220000000000000000000000000000000000000000000000000000000000000000000000002022
20220000000000000000000000000000000000000000000000000000000000000000000000003032
20220000000000000000000000000000000000000000000000000000000000000000000000000000
20220000000000000000000000000000000000000000000000000000000000000000000000000000
20220000000000000000000000000000000000000000000000000000000001070102060106060303
20220000000000000000000000000000000000000000000000000000000010111111111111111112
20220000000000000000000000000000000000000000000000000000000020212121212121212122
20220000000000000000000000000000000000000000000000000000000020212121212121212122
20220000000000000000000000000000000000000000000000000000000020212121212121212122
20220000000000000000000000000000000000000000000000000000000020212121212121212122
20220000000000000000000000000000000000000000000000000000000020212121212121212122
20220000000000000000000000000000000000000000000000000000000020212121212121212122
20220000000000000000000000000000000000000000000000000000000020212121212121212122
20220000000000000000000000000000000000000000000000000000000020212121212121212122
20220000000000000000000000000000000000000000000000000000000020212121212121212122
20220000000000000000000000000000000000000000000000000000000020212121212121212122
20220000000000000000000000000000000000000000000000000000000020212121212121212122
20220000000000000000000000000000000000000000000000000000000020212121212121212122
20220000000000000000000000000000000000000000000000000000000020212121212121212122
20220000000000000000000000000000000000000000000000000000000020212121212121212122
20220000000000000000000000000000000000000000000000000000000020212121212121212122
20220000000000000000000000000000000000000000000000000000000020212121212121212122
20220000000000000000000000000000000000000000000000000000000020212121212121212122
20220000000000000000000000000000000000000000000000000000000020212121212121212122
20220000000000000000000000000000000000000000000000000000000020212121212121212122
20220000000000000000000000000000000000000000000000000000000020212121212121212122
20220000000000000000000000000000000000000000000000000000000020212121212121212122
20220000000000000000000000000000000000000000000000000000000020212121212121212122
20220108010206010201020801020703040403060301040703010308040120212121212121212122
20231111111111111111111111111111111111111111111111111111111124212121212121212122
30313131313131313131313131313131313131313131313131313131313131313131313131313132

image image:3
