56565656565656565656565656565656565656565656565656565656575a5c203d3e21213f3d2d3e
56565648666666666666666666666666666666666666666666666666675a5c202e2d3d2d3f3f2e2d
56565657000000000000000000000000000000000000000000000000005a5c203f3e213e2e3f2d3e
56565657000000000000000000000000000000000000000000000000005a5c20212e2e2e213f2d3f
56565657000000000000000000000000000000000000000000000000005a5c203e3e2d2e3f2d212d
56565657000000000000000001040203040101030000000000000000005a5c202d3e213f2e213f3d
5656565700000000000000004a4b4b4b4b4b4b4c0000000000000000005a5c203f3f3d3e2d3e3d3f
5656565700000000000000005a5b5b5b5b5b5b5c0000000000000000005a5c202d3e3e3f3e3f3d2d
5656565700000000000000005a5b5b5b5b5b5b5c0000000000000000005a5c202e212d2d213d213f
4866666700000000000000006a4e5b5b5b5b5b5c0000000000000000005a5c20213e2d3f2d3e3d3e
570000000000000000000000005a5b5b5b5b5b5c0000000000000000005a5c303131313131313131
570000000000000000000000005a5b5b5b5b5b5c0000000000000000005a5c000000000000000000
570000000000000000000000005a5b5b5b5b5b5c0706070606070708065a5c000000000000000000
570000000000000000000000006a4e5b5b5b5b5d4b4b4b4b4b4b4b4b4b5e5c000000000106040203
57000000000000000000000000005a5b5b5b5b5b5b5b4d6b6b6b6b6b6b6b6c000000001011111111
57000000000000000000000000005a5b5b5b5b5b5b5b5c000000000000000000000000202d3e3f2e
57000000000000000000000000005a5b5b5b5b5b4d6b6c000000000000000000000306203d3d2e2d
57000000000000000000000000006a4e5b5b5b5b5c0000000000000000000000001011242d213f3e
5700000000000000000000000000005a5b5b5b4d6c000000000000000000000604203f3f3f2d3e21
5700000000000000000000000000005a5b5b5b5c0000000000000000000000101124212d213d3d2e
5700000000000000000000000000005a5b5b5b5c000000000000000000010820213f2e2d3e3f2121
5700000000000000000000000000006a4e5b5b5c0000000000000000001011243d3e2d3e21213d21
570000000000000000000000000000005a5b5b5c000000000000000101203d3f3d2e3d3e2d213f21
570000000000000000000000000000005a5b5b5c0000000000000010112421213d2e2e3d21212e2d
570000000000000000000000000000005a5b5b5c0000000000020620213d3d3f2e3d213d3e3e2d3e
570000000000000000000000000000006a4e5b5c00000000001011243f3d2e3e2d3e212e2e2d3e2e
57000000000000000000000000000000005a5b5c0000000000203e2d3e3e3f2d3d213e2e213e3e3e
57000000000000000000000000000000005a5b5c0000000000203d2e213f3f3d213e3e2d212d3d2e
57000000000000000000000000000000005a5b5c00000001032021212d2d212e3f3f3d3d3d213f2d
57000000000000000000000000000000006a6b6c0000001011243e2e213f3d3f2e2d3f3e3d3e3d21
570000000000000000000000000000000000000000000020213f3f3d3e213f2e2d213d2e3f213d3f
570000000000000000000000000000000000000000000020212d213f213f213f213d3f3f3d3f2e21
6704060508070308050607020408080603050305040803203e2e212e3d3f3f3d3e213d212e21213f
111111111111111111111111111111111111111111111124213e2d2d2d2d2d3d2e3d3f212d2d2e3e
3f213e2d2e2d3e2d213d3d2d3f3f2e212e21213d2d3d3f212e3e2d3f3e3d2d3d213e3e2e2d2e213d
3f3e2d3d212e3f21213e2e2d3d3e213e213e3f2d3e3e3e3d3e3d3d3f3f213d3d3e3e3f2e3e2e2e3d
3d3d3e3f213d2d3e21212d3d3e2d3f3f3f3f3e3e212d2d2e21212d3e3f3f3e3d2d2e212d3f3f3e2e
3d2e2e2e21212e3e3e3e3f3d2121212e2e3e3e2d3f2121212e2e3e3f3f2e2e2d2d2d21213f2d3e21
2e3e2e3d3e3d2121212e3f2d212d2e2d3d3f2e3f3d213e2e3d3f212d3d2e2e3f3d3d213e2e2d2d21
3d2d3f3f21212d3d2d2d3e3f2e2d3d2e213e21212d2e212e3f3e2d3e3e21212d2d3d2d2d3f3d2e2d

image image:3
