21212121212121212121212121212121212121212121212121212121212121212121212121212121
21212113313131313131313131313131313131313131313131313131311421212121212121212121
21212122000000000000000000000000000000000000000000000000002021212121212121212121
21212122000000000000000000000000000000000000000000000000002021212121212121212121
21212122000000000000000000000000000000000000000000000000002021212121212121212121
21212122000000010203020104020400000000000000000000000000002021212121212121212121
21212122000000101111111111111200000000000000000000000000002021212121212121212121
21212122000000202121212121212200000000000000000000000000002021212121212121212121
21212122000000202121212121212200000000000000000000000000002021212121212121212121
13313132000000301421212121212200000000000000000000000000002021212121212121212121
22000000000000002021212121212200000000000000000000000000002013313131313131313131
22000000000000002021212121212200000000000000000000000000002022000000000000000000
22000000000000002021212121212207080207020703050707030601052022000000000000000000
22000000000000003014212121212311111111111111111111111111112422000000000306010202
22000000000000000020212121212121212121212121133131313131313132000000001011111111
22000000000000000020212121212121212121212121220000000000000000000000002021212121
22000000000000000020212121212121212121211331320000000000000000000003082021212121
22000000000000000030142121212121212121212200000000000000000000000010112421212121
22000000000000000000202121212121212113313200000000000000000000060220212121212121
22000000000000000000202121212121212122000000000000000000000000101124212121212121
22000000000000000000202121212121133132000000000000000000000407202121212121212121
22000000000000000000301421212121220000000000000000000000001011242121212121212121
22000000000000000000002021212121220000000000000000000001012021212121212121212121
22000000000000000000002021212121220000000000000000000010112421212121212121212121
22000000000000000000002021212121220000000000000000010620212121212121212121212121
22000000000000000000003014212121220000000000000000101124212121212121212121212121
22000000000000000000000020212121220000000000000704202121212121212121212121212121
22000000000000000000000020212121220000000000001011242121212121212121212121212121
22000000000000000000000020212121220000000001042021212121212121212121212121212121
22000000000000000000000030313131320000000010112421212121212121212121212121212121
22000000000000000000000000000000000000010520212121212121212121212121212121212121
22000000000000000000000000000000000000101124212121212121212121212121212121212121
22010805080503060607060102060708030703202121212121212121212121212121212121212121
23111111111111111111111111111111111111242121212121212121212121212121212121212121
21212121212121212121212121212121212121212121212121212121212121212121212121212121
21212121212121212121212121212121212121212121212121212121212121212121212121212121
21212121212121212121212121212121212121212121212121212121212121212121212121212121
21212121212121212121212121212121212121212121212121212121212121212121212121212121
21212121212121212121212121212121212121212121212121212121212121212121212121212121
21212121212121212121212121212121212121212121212121212121212121212121212121212121

image image:3
