2121212121212121212121212121221f202121212121212121212121212121212121212121212121
2121212121212121212121212121221f202121212121212121212121212121212121212121212121
2121212121212121212121212121221f202121212121212121212121212121212121212121212121
2121212121212121212121212121221f202121212121212121212121212121212121212121212121
2121212121212121212121212121221f202121212121212121212121212121212121212121212121
2113313131313131313131313131321f303131313114212121133131313131313131313131311421
2122000000000000000000000000001f000000000020212121220000000000000000000000002021
2122000000000000000000000000001f000000000020212121220000000000000000000000002021
2122000000000000000000000000001f000000000020212121220000000000000000000000002021
2122000000000000000000000000001f000000000020212121220000000000000000000000002021
21220000000000000000001516161616161616161720212121220000000000000000000000002021
21220000000000000000002526262626262626262720212121220000000000000000000000002021
21220000000000000000002526262626262626262720212121220000000000000000000000002021
21220000000000000000003536363636363636363720212121220000000000000000000000002021
21220000000000000000000000000000000000000020212121220000000000000000000000002021
21220000000000000000000000000000000000000020212121220000000000000000000000002021
21220000000000000000000000000000000000000030313131320000000000000000000000002021
21220000000000000000000000000000000000000000000000000000000000000000000000002021
21220000000000000000000000000000000000000000000000000000000000000000000000002021
21220000000000000000000000000000000000000000000000000000000000000000000000002021
21220000000000000000000000000000151616161616161700000000000000000000000000002021
21220000000002080204050307030603353636363636363701040306060403050203000000002021
21220000000010111111111111111111111111111111111111111111111111111112000000002021
21220000000020212121212121212121212121212121212121212121212121212122000000002021
21220000000030313131313131313131313131313131313131313131313131313132000000002021
21220000000000000000000000000000000000000000000000000000000000000000000000002021
21220000000000000000000000000000000000000000000000000000000000000000000000002021
21220000000000000000000000000000000000000000000000000000000000000000000000002021
21220000000000000000000000000000000000000000000000000000000000000000000000002021
21220000000000000000000000000000000000000000000000000000000000000000000000002021
21220000000000000000000000000000000000000000000000000000000000000000000000002021
21220000000000000000000000000000000000000000000000000000000000000000000000002021
21220000000000000000000000000000000000000000000000000000000000000000000000002021
21220000000000000000000000000000000000000000000000000000000000000000000000002021
21220000000000000000000000000000000000000000000000000000000000000000000000002021
21220000000000000000000000000000000000000000000000000000000000000000000000002021
21220000000000000000000000000000000000000000000000000000000000000000000000002021
21220704010503010801040804030408030503010102070206010203070202060402020703022021
21231111111111111111111111111111111111111111111111111111111111111111111111112421
21212121212121212121212121212121212121212121212121212121212121212121212121212121

image image:3
