2121212121212121212121212121221f202121212121212121212121212121212121212121212121
2121212121212121212121212121221f202121212121212121212121212121212121212121212121
2121212121212121212121212121221f202121212121212121212121212121212121212121212121
2121212121212121212121212121221f202121212121212121212121212121212121212121212121
2121212121212121212121212121221f202121212121212121212121212121212121212121212121
2113313131313131313131313131321f303131313131313131313131313131313131313131311421
2122000000000000000000000000001f000000000000000000000000000000000000000000002021
2122000000000000000000000000001f000000000000000000000000000000000000000000002021
2122000000000000000000000000001f000000000000000000000000000000000000000000002021
2122000000000000000000010204041f020301010100000000000000000000000000000000002021
21220000000000000000001516161616161616161700000000000000000000000000000000002021
21220000000000000000002526262626262626262700000000000000000000000000000000002021
21220000000000030103012526262626262626262701030706030000000000000000000000002021
21220000000000101111111111111111111111111111111111120000000000000000000000002021
21220000000000202121212121212121212121212121212121220002050200000000000000002021
21220000000000303131313131313131313131313131313131320015161700000000000000002021
21220000000000000000000000000000000000000000000000000025262700000000000000002021
21220000000000000000000000000000000000000000000000000025262700000000000000002021
21220000000000000000000000000000000000000000000000000025262700000000000000002021
21220000000000000000000000000000030308080303070707030225262702020000000000002021
21220000000000000000000000000000151616161616161616161616161616170000000000002021
21220000000003010207050508020104252626262626262626262626262626270302000000002021
21220000000010111111111111111111111111111111111111111111111111111112000000002021
21220000000020212121212121212121212121212121212121212121212121212122000000002021
21220000000030313131313131313131313131313131313114133131313131313132000000002021
21220000000000000000000000000000000000000000000020220000000000000000000000002021
21220000000000000000000000000000000000000000000030320000020400000000000000002021
21220000000000000000000000000000000000000000000000000000101200000000000000002021
21220000000000000000000000000000000000000000010101020304202204040402040206012021
21220000000004030403030401040203030100000000101233341011242311111111111111112421
21220000000015161616161616161616161700000000303200003031313131313131313131311421
21220000000025262626262626262626262700000000000000000000000000000000000000002021
21220000000035363636363636363636363700000000000000000000000000000000000000002021
21220000000000000000030201010000000000000000040301030204060808080705080105022021
21220000000000000000151616170000000000000000101111111111111111111111111111112421
21220000000000000000353636370000000000000000202121212121212121212121212121212121
21220000000000000000000000000000000000000000202121212121212121212121212121212121
21220408010407050402050401030708020401030803202121212121212121212121212121212121
21231111111111111111111111111111111111111111242121212121212121212121212121212121
21212121212121212121212121212121212121212121212121212121212121212121212121212121

image image:3
sprite @25,30 sprite:flamethrower (u8:flag)sflame 0x031400
sprite @32,28 sprite:treadle (u8:flag)sflame 0x000000
sprite @34,28 sprite:goat 0x00000000
sprite @24,30 sprite:flamethrower (u8:flag)sflame 0x031400
