3d3d3f3e21212e2e2d2e2d2e3d3e221f253c3b3a3c3c263c3b3a3c3c3a263a3b3b3a3c3a3c3c3c3c
3d3f213f3f2e3d2d213d2d3e3d3f221f253c3a3a3a3b2626263a3b3c3c3b263a263b3c3a3c3c3c3a
2e3f3e3d213e21213e3f2e3e213f221f253a3a3c3c263b263b3a3b3c263b26263c3c263a3a263a3b
2d3e3f3d3d213d2e213f2e3d3d2e221f253b263a3a3c3b3b3c3c263b3b263b3c263b263a3b3c3c3a
3d3d2e2e3f3f3e3f2e2e2e3d3f3f221f253c3c3c3b3b3c3a3b3b3c3c3a3c3a3c263b26263b3a3b26
3e13313131313131313131313131321f35363636363636363636363636363636363636363636193c
2122000000000000000000000000001f00000000000000000000000000000000000000000000253a
2122000000000000000000000000001f00000000000000000000000000000000000000000000253a
2122000000000000000000000000001f00000000000000000000000000000000000000000000253a
21220000000000000000001a0000001f00000000000000000000000000000000000000000000253c
21220000000000000000002a2b2b2b2b2b2b2b2b2c0000000000000000000000000000000000253b
21220000000000000000000000000000000000000000000000000000000000000000000000002526
21220000000000040104030207020303050303010202030505010000000000000000000000002526
3d220000000000101111111111111111111111111111111111120000000000000000000000002526
2d22000000000020213e3d3e2d212d3f3d3e3d3f2e2d3f212122000000000000000000000000253a
3f2200000000003031313131313131313131313131313131313200090b0d0000000000000000253c
3e22000000000000000000000000000000000000000000000000000000000000000000000000253b
3d22000000000000000000000000000000000000000000000000000000000000000000000000253a
2122000000000000000000000000000000000000000000000000000000000000000000000000253a
2e2200000000000000000000000000001b1c1c1d1c1d1c1c1d1d1d1d1c1d1d1e0000000000002526
3e22000000000000000000000000000000000000000000000000000000000000000000000000253c
3f220000000002010105070107030108030201040105010202010408010202040104000000002526
3e220000000010111111111111111111111111111111111111111111111111111112000000002526
3f2200000000202e2e3d213e3e3e3d3e3e3f3e2e2d2e2d3d2d2e213d3d3f2d3d3d22000000002526
3f22000000003031313131313131313131313131313131311413313131313131313200000000253c
3d22000000000000000000000000000000000000000000002022000000000000000000000000253a
2122000000000000000000000000000000000000000000003032000000000000000000000000253a
2e220000000000000000000000000000000000000000000000000000797a0000000000000000253c
3e220000000000000000000000000000000000000000010503020402898a03040401010308032526
3d22000000001a00000000000000000000000000000015757677781616161616161616161616293c
3e22000000002a2b2b2b2b2b2b2b2b2b2b2c0000000035370000353636363636363636363636193c
3e220000000000000000000000000000000000000000000000000000000000000000000000002526
3e22000000000000000000000000000000000000000000000000000000000000000000000000253c
2e22000000000000000000000000000000000000000003040401040408080507080805020601253c
2d220000000000000000090a0a0d000000000000000015161616161616161616161616161616293b
2d22000000000000000000000000000000000000000025263c3b3a263c3b3a263c3b3a263a26263c
3f220000000000000000000000000000000000000000253a3b3a3b26263b3a3b263a3c3b26262626
2d220308010205080104060308020606030402040804253c3b3b3b3a3a3a3a3c3c3b263b3c263b3a
3e224a4b4b4b4b4b4b4b4b4b4b4b4b4b4b4b4b4b4b4c25263a3b3c3c3b3b263b3a263a263b3a3a3c
2e225a5b5b5b5b5b5b5b5b5b5b5b5b5b5b5b5b5b5b5c2526263a3b26263c3b2626263b2626263c3a

image image:3
sprite @25,30 sprite:flamethrower (u8:flag)sflame 0x031400
sprite @32,28 sprite:treadle (u8:flag)sflame 0x000000
sprite @34,28 sprite:goat 0x00000000
sprite @24,30 sprite:flamethrower (u8:flag)sflame 0x031400
