3f2d213f3f2d3e3f212d2e2d3d3e3d3f2d3f21212d3d3f3e3f3e3d3f212e2e213d2d2d212d3e2e3f
3e3e2e3e212e2d2e3f3d3d2d2d3f2113313131313131142d2d2d213f212d3d212e3d3f2d3e2d2e3f
21212d213e2e3e2e3e2e2d3f3d2e133200000000000030142e3e2d2e3d3e2121212e2e3f213e2e3e
2d2e212d2e2e3d3d2d3e212e3f133200000000000000003014212e3f3d213f2d3f212d3e2d2e2e3e
213d3e3d3d3e2e3f3d2d3f2e13320000000000000000000030142e2e2e2e3f213e2e2e2d2d213d2d
2e3e3e3f2e3d3e3e3d2e21133200000000000000000000000030143e2e3d2e3f21212e2e213e2d3e
3e2e3e3f3e2d213f3d3e1332000000000000000000000000000030142d2e212e2e3f2d2e3d213f3f
2d212e2d3f3f3f213f13320000000000000000000000000000000030142d3e3e3f3f2d3e2d3e3d2e
3d3d2e2d3d2e3d3e13320000000000000000000000000000000000003014213e2d213d213f2e213f
3d2d2d2e2d212d1332000000000000000000000000000000000000000030142d3e213f3f2e3e2d3f
3f2e3e2e213f1332000000000000000000000000000000000000000000003014213e3d2d2e213d3d
3f3f213e21133200000000000000000206020801050201000000000000000030142e2d213d2e213f
3e2e213e1332000000000000000000151616161616161700000000000000000030143e3f3f213e3d
2d3f2d13320000000000000000000035363636363636370000000000000000000030143d3e2d3e3f
3d2113320000000000000000000000004f000000004f00000000000000000000000030142d3f3f21
313132000000000000000000000000005f000000005f0000000000000000000000000030142e213d
000000000000000000000000000708046f070508076f020703000000000000000000000030143e2d
0000000000000000000000000015161616161616161616161700000000000000000000000030143e
00000000000000000000000000353636363636363636363637000000000000000000000000002021
03040501000000000000000000004f00000000000000004f00000000000000000000000000002021
16161617000000000000000000005f00000000000000005f00000000000000000000000000002021
3a3b3a27030503070602050605036f08010603060408056f03010707020308030406080306033031
3b262628161616161616161616161616161616161616161616161616161616161616161616161616
3c3a3c3a3a3a3c3a3b3c3c3a3c3a3b3a263a3a263b3b3a3a3c3a2626263a3c263c3a3b3a3a3b3a3b

image image:3
