10111111111111111111111111111111111111111111111111111111111111111111111111111112
20212121212121212121212121212113313131313131142121212121212121212121212121212122
20212121212121212121212121211332000000000000301421212121212121212121212121212122
20212121212121212121212121133200000000000000003014212121212121212121212121212122
20212121212121212121212113320000000000000000000030142121212121212121212121212122
20212121212121212121211332000000000000000000000000301421212121212121212121212122
20212121212121212121133200000000000000000000000000003014212121212121212121212122
20212121212121212113320000000000000000000000000000000030142121212121212121212122
20212121212121211332000000000000000000000000000000000000301421212121212121212122
20212121212121133200000000000000000000000000000000000000003014212121212121212122
20212121212113320000000000000000000000000000000000000000000030142121212121212122
20212121211332000000000000000002060206020503020000000000000000301421212121212122
20212121133200000000000000000010111111111111120000000000000000003014212121212122
20212113320000000000000000000030313131313131320000000000000000000030142121212122
20211332000000000000000000000000330000000033000000000000000000000000301421212122
30313200000000000000000000000000340000000034000000000000000000000000003014212122
00000000000000000000000000060702340605080634020701000000000000000000000030142122
00000000000000000000000000101111111111111111111112000000000000000000000000301422
00000000000000000000000000303131313131313131313132000000000000000000000000002022
01030502000000000000000000003300000000000000003400000000000000000000000000002022
10111112000000000000000000003300000000000000003300000000000000000000000000002022
20212122040601060802050705043406040704050208073402040806020405030408050305032022
20212123111111111111111111111111111111111111111111111111111111111111111111112422
30313131313131313131313131313131313131313131313131313131313131313131313131313132

image image:3
