10111111111111111111111111111111111111111111111111111111111111111111111111111112
20133131313131313131313131313131313131313131313131313131313131313131313131311422
20220000000000000000000000000000000000000000000000000000000000000000000000002022
20220000000000000000000000000000000000000000000000000000000000000000000000002022
20220000000000000000000000000000000000000000000000000000000000000000000000002022
20220000000000000000000000000000000000000000000000000000000000000000000000002022
20220000000000000000000000000000000000000000000000000000000000000000000000002022
20220000000000000000000000000000000000000000000000000000000000000000000000002022
20220000000000000000000000000000000000000000000000000000000000000000000000002022
20220000000039000000000000000000000000000000000000000000000000000000000000002022
20220000000000000000000000000000380000000000000000000000000000000000000000002022
20220000000000000000000000000000000000000000000000003900000000000000000000002022
20220000000000000000000000000000000000000000000000000000000000000000003800002022
20220000000000000000000000000000000000000000000000000000000000000000000000002022
20220000000000070708060806080605000000000000000000000000000000000000000000002022
30320000000000151617393839151617000000000000000000000000000000000000000000102422
00000000000000353637555657353637000000000000000000000000000038000000000000301422
00000000000000000000000000000000000000000000003900000000000000000000000000002022
00000000000000000000000000000000003900000000000000000000000000000000000000002022
00000000000000000000000038000000000000000000000000000000000000000000000000002022
10111111111111111200000000000000000000000000000000000000000000000000000000002022
20212121212121212200000000000000000000000000000000000000000000000000000000002022
20212121212121212200000000000000000000000000000000000000000000000000000000002022
20212121212121212200000000000000000000000000000000000000000000000000000000002022
20212121212121212200000000000000000000000000000000000000000000000000000000002022
20212121212121212200000000000000000000000000000000000000000000000000000000002022
20212121212121212200000000000000000000000000000000000000000000000000000000002022
20212121212121212200000000000000000000000000000000000000000000000000000000002022
20212121212121212200000000000000000000000000000000000000000000000000000000002022
20212121212121212200000000000000000000000000000000000000000000000000000000002022
20212121212121212200000000000000000000000000000000000000000000000000000000002022
20212121212121212200000000000000000000000000000000000000000000000000000000002022
20212121212121212200000000000000000000000000000000000000000000000000000000002022
20212121212121212200000000000000000000000000000000000000000000000000000000002022
20212121212121212200000000000000000000383838393939383938383938383939380000002022
20212121212121212200000000000000000000000000000000000000000000000000000000002022
20212121212121212200000000000000000000000000000000000000000000000000000000002022
20212121212121212200080808080008080808000808080800080808080008080800000000002022
20212121212121212311111111111111111111111111111111111111111111111111111111112422
30313131313131313131313131313131313131313131313131313131313131313131313131313132

image image:3
