10111111111111111111111111111111111111111111111111111111111111111111111111111112
20133131313131313131313131313131313131313131313131313131313131313131313131311422
20220000000000000000000000000000000000000000000000000000000000000000000000002022
20220000000000000000000000000000000000000000000000000000000000000000000000002022
20220000000000000000000000000000000000000000000000000000000000000000000000002022
20220000000000000000000000000000000000000000000000000000000000000000000000002022
20220000000000000000000000000000000000000000000000000000000000000000000000002022
20220000000000000000000000000000000000000000000000000000000000000000000000002022
20220000000000000000000000000000000000000000000000000000000000000000000000002022
20220000000039000000000000000000000000000000000000000000000000000000000000002022
20220000000000000000000000000000380000000000000000000000000000000000000000002022
20220000000000000000000000000000000000000000000000003900000000000000000000002022
20220000000000000000000000000000000000000000000000000000000000000000003800002022
20220000000000000000000000000000000000000000000000000000000000000000000000002022
20220000000000000000000000000000000000000000000000000000000000000000000000082022
30320000000000000000000000000000000000000000000000000000000000000000000000102422
00000000000000000000000000000000000000000000000000000000000038000000000000301422
00000000000000000000000000000000000000000000003900000000000000000000000000002022
00000000000000000000000000000000003900000000000000000000000000000000000000002022
01030504010501060300000038000000000000000000000000000000000000000000000000002022
10111111111111111200000000000000000000000000000000000000000000000000000000002022
20212121212121212200000000000000000000000000000000000000000000000000000000002022
20212121212121212200000000000000000000000000000000000000000000000000000000002022
20212121212121212200000000000000000000000000000000000000000000000000000000002022
20212121212121212200000000000000000000000000000000000000000000000000000000002022
20212121212121212200000000000000000000000000000000000000000000000000000000002022
20212121212121212200000000000000000000000000000000000000000000000000000000002022
20212121212121212200000000000000000000000000000000000000000000000000000000002022
20212121212121212200000000000000000000000000000000000000000000000000000000002022
20212121212121212200000000000000000000000000000000000000000000000000000000002022
20212121212121212200000000000000000000000000000000000000000000000000000000002022
20212121212121212200000000000000000000000000000000000000000000000000000000002022
20212121212121212200000000000000000000000000000000000000000000000000000000002022
20212121212121212200000000000000000000000000000000000000000000000000000000002022
20212121212121212200000000000000000000000000000000000000000000000000000000002022
20212121212121212200000000000000000000000000000000000000000000000000000000002022
20212121212121212200000000000000000000000000000000000000000000000000000000002022
20212121212121212201030802040804050104050203010202020801070401010701040502022022
20212121212121212311111111111111111111111111111111111111111111111111111111112422
30313131313131313131313131313131313131313131313131313131313131313131313131313132

image image:3
