10111111111111111200000010111111111111111111111111111111111111111111111111111112
20133131313131313200000030313131313131313131313131313131313131313131313131311422
20220000000000000000000000000000000000000000000000000000000000000000000000002022
20220000000000000000000000000000000000000000000000000000000000000000000000002022
20220000000015161616161616170000000000000000000000000000000000000000000000002022
30320000000035363636363636370000000000000000000000000000000000000000000000002022
00000000000000000000000000000000000000000000000000000000000000000000000000002022
00000000000000151616161616161617000000000000000000000000000000000000000000002022
00000000000000353636363636363637000000000000000000000000000000000000000000002022
10120000000000000000000000000000000000000000000000000000000000000000000000002022
20220000000000000000151616161616170000000000000000000000000000000000000000002022
20220000000000000000353636363636370000000000000000000000000000000000000000002022
20220000000000000000000000000000000000000000000000000000000000000000000000002022
20220000000000001516161616170000000000000000000000000000000000000000000000002022
20220000000000003536363636370000000000000000000000000000000000000000000000002022
30320000000000000000000000000000000000000000000000000000000000000000000000002022
00000000000015161616161700000000000000000000000000000000000000000000000000002022
00000000000035363636363700000000000000000000000000000000000000000000000000002022
00000000000000000000000000000000000000000000000000000000000000000000000000002022
01020403010403030300000000000000000000000000000000000000000000000000000000002022
10111111111111111200000000000000000000000000000000000000000000000000000000002022
20212121212121212200000000000000000000000000000000000000000000000000000000002022
20212121212121212200000000000000000000000000000000000000000000000000000000002022
20212121212121212200000000000000000000000000000000000000000000000000000000002022
20212121212121212200000000000000000000000000000000000000000000000000000000002022
20212121212121212200000000000000000000000000000000000000000000000000000000002022
20212121212121212200000000000000000000000000000000000000000000000000000000002022
20212121212121212200000000000000000000000000000000000000000000000000000000002022
20212121212121212200000000000000000000000000000000000000000000000000000000002022
20212121212121212200000000000000000000000000000000000000000000000000000000002022
20212121212121212200000000000000000000000000000000000000000000000000000000002022
20212121212121212200000000000000000000000000000000000000000000000000000000003032
30313131313131313200000000000000000000000000000000000000000000000000000000000000
00000000000000000000000000000000000000000000000000000000000000000000000000000000
00000000000000000000000000000000000000000000000000000000000000000000000000000000
10111111111111111200000000000000000000000000000000000000000000000000000000001012
20212121212121212200000000000000000000000000000000000000000000000000000000002022
20212121212121212201020303040403040303010300000004030101030402040102030401022022
20212121212121212311111111111111111111111200000010111111111111111111111111112422
30313131313131313131313131313131313131313200000030313131313131313131313131313132

image image:3
